NO ./assets/textures/wall.png
WE ../textures/stone.xpm
SO /usr/share/textures/wood.bmp
EA ./very_long_filename_texture_name.png

C 252,116,50
F 180,4,46

11111
10001
10N01
10001
11111