NO ./very_long_filename_texture_name.png
WE ./assets/subfolder/texture.png
SO texture.png
EA ./123numeric.png

C 119,188,48
F 152,131,43

11111
10001
10N01
10001
11111