NO ./assets/subfolder/texture.png
WE texture.png
SO ./123numeric.png
EA ./under_score.png

C 226,25,123
F 129,211,181

11111
10001
10N01
10001
11111