NO ./123numeric.png
WE ./under_score.png
SO ./with-dash.png
EA ./assets/debug_north.png

C 158,210,70
F 82,118,191

11111
10001
10N01
10001
11111