NO ./under_score.png
WE ./with-dash.png
SO ./assets/debug_north.png
EA ./assets/textures/wall.png

C 136,165,214
F 15,177,4

11111
10001
10N01
10001
11111