NO ./assets/debug_north.png
WE ./assets/textures/wall.png
SO ../textures/stone.xpm
EA /usr/share/textures/wood.bmp

C 58,21,211
F 209,35,11

11111
10001
10N01
10001
11111