NO ./assets/textures/wall.png
WE ../textures/stone.xpm
SO /usr/share/textures/wood.bmp
EA ./very_long_filename_texture_name.png

C 90,16,10
F 185,127,160

11111
10001
10N01
10001
11111