NO /usr/share/textures/wood.bmp
WE ./very_long_filename_texture_name.png
SO ./assets/subfolder/texture.png
EA texture.png

C 185,105,128
F 217,79,182

11111
10001
10N01
10001
11111