NO texture.png
WE ./123numeric.png
SO ./under_score.png
EA ./with-dash.png

C 215,19,240
F 252,191,161

11111
10001
10N01
10001
11111