NO ./under_score.png
WE ./with-dash.png
SO ./assets/debug_north.png
EA ./assets/textures/wall.png

C 211,95,180
F 124,136,172

11111
10001
10N01
10001
11111