NO ./assets/debug_north.png
WE ./assets/textures/wall.png
SO ../textures/stone.xpm
EA /usr/share/textures/wood.bmp

C 232,94,196
F 148,160,169

11111
10001
10N01
10001
11111