NO ./assets/textures/wall.png
WE ../textures/stone.xpm
SO /usr/share/textures/wood.bmp
EA ./very_long_filename_texture_name.png

C 237,106,15
F 218,191,139

11111
10001
10N01
10001
11111