NO ../textures/stone.xpm
WE /usr/share/textures/wood.bmp
SO ./very_long_filename_texture_name.png
EA ./assets/subfolder/texture.png

C 203,169,253
F 185,23,39

11111
10001
10N01
10001
11111