NO ./very_long_filename_texture_name.png
WE ./assets/subfolder/texture.png
SO texture.png
EA ./123numeric.png

C 195,189,196
F 102,83,235

11111
10001
10N01
10001
11111