NO ./assets/subfolder/texture.png
WE texture.png
SO ./123numeric.png
EA ./under_score.png

C 90,48,31
F 221,217,12

11111
10001
10N01
10001
11111