NO texture.png
WE ./123numeric.png
SO ./under_score.png
EA ./with-dash.png

C 89,120,133
F 227,181,185

11111
10001
10N01
10001
11111