NO ./123numeric.png
WE ./under_score.png
SO ./with-dash.png
EA ./assets/debug_north.png

C 49,83,85
F 154,202,88

11111
10001
10N01
10001
11111