NO ./assets/subfolder/texture.png
WE texture.png
SO ./123numeric.png
EA ./under_score.png

C 131,144,8
F 230,240,135

11111
10001
10N01
10001
11111