NO ./under_score.png
WE ./with-dash.png
SO ./assets/debug_north.png
EA ./assets/textures/wall.png

C 224,86,253
F 159,126,30

11111
10001
10N01
10001
11111