NO ./assets/debug_north.png
WE ./assets/debug_west.png
SO ./assets/debug_south.png
EA ./assets/debug_east.png

C 255,150,100
F 100,150,255

111111111
100000001
100000001
100000001
1000S00001
100000001
100000001
100000001
111111111