NO ./assets/debug_north.png
WE ./assets/debug_west.png
SO ./assets/debug_south.png
EA ./assets/debug_east.png

C 200,200,255
F 255,200,200

11111111111
10000000001
10000000001
10000000001
10000000001
10000S000001
10000000001
10000000001
10000000001
10000000001
11111111111