NO ./assets/debug_north.png
WE ./assets/debug_west.png
SO ./assets/debug_south.png
EA ./assets/debug_east.png

C 150,150,150
F 100,100,100

11111111111
10001010001
11000000001
10110001011
11100000011
10000N10001
10000100001
11000001001
10000110011
10100100001
11111111111