NO ./assets/debug_north.png
WE ./assets/debug_west.png
SO ./assets/debug_south.png
EA ./assets/debug_east.png

C 150,150,150
F 100,100,100

111111111111
100001000111
100100000111
110001001011
110000010001
100010000001
100100N01001
101100110001
101010000001
101010111101
101011100111
111111111111