NO ./assets/debug_north.png
WE ./assets/debug_west.png
SO ./assets/debug_south.png
EA ./assets/debug_east.png

C 150,150,150
F 100,100,100

1111111111111
1000100000001
1000001000011
1100101000001
1001010000101
1110010110001
100000N000001
1101000000001
1010000001101
1000001011001
1000000100011
1100011011001
1111111111111