NO ./assets/debug_north.png
WE ./assets/debug_west.png
SO ./assets/debug_south.png
EA ./assets/debug_east.png

C 150,150,150
F 100,100,100

11111
10101
11N01
11011
11111