NO ./assets/debug_north.png
WE ./assets/debug_west.png
SO ./assets/debug_south.png
EA ./assets/debug_east.png

C 150,150,150
F 100,100,100

11111111
10000101
11010001
11010001
1001N101
10010111
10000001
11111111