NO ./assets/debug_north.png
WE ./assets/debug_west.png
SO ./assets/debug_south.png
EA ./assets/debug_east.png

C 150,150,150
F 100,100,100

1111111111
1000110001
1000000011
1011001001
1110110001
10000N1011
1001110001
1001010011
1010000101
1111111111