NO ./assets/debug_north.png
WE ./assets/debug_west.png
SO ./assets/debug_south.png
EA ./assets/debug_east.png

C 150,150,150
F 100,100,100

11111111111
10000010001
10010000101
10011010011
11010000011
10100N00001
10001101001
10101000011
11000100001
10100000111
11111111111