NO ./assets/debug_north.png
WE ./assets/debug_west.png
SO ./assets/debug_south.png
EA ./assets/debug_east.png

C 150,150,150
F 100,100,100

111111111111
101100010101
101001100001
101000001111
111110001001
101000001001
110100N00101
110000100001
100100001001
100001100011
100010101011
111111111111