NO ./assets/debug_north.png
WE ./assets/debug_west.png
SO ./assets/debug_south.png
EA ./assets/debug_east.png

C 150,150,150
F 100,100,100

11111111111111
10000000011001
10000000000101
11110101111001
10000000011001
10111000111101
10000001011001
1000101N000101
11010000000101
11000111000001
10000110000001
10011101000001
11101111000011
11111111111111