NO ./assets/debug_north.png
WE ./assets/debug_west.png
SO ./assets/debug_south.png
EA ./assets/debug_east.png

C 150,150,150
F 100,100,100

111111111
101100001
101000111
110101001
1000N0001
100000001
111000011
101000111
111111111