NO ./assets/debug_north.png
WE ./assets/debug_west.png
SO ./assets/debug_south.png
EA ./assets/debug_east.png

C 150,150,150
F 100,100,100

1111111111
1000001001
1100000101
1010101101
1000100001
10001N0001
1000100011
1100010011
1000000101
1111111111