NO ./assets/debug_north.png
WE ./assets/debug_west.png
SO ./assets/debug_south.png
EA ./assets/debug_east.png

C 150,150,150
F 100,100,100

1111111111111
1000001000011
1100000100111
1010100110101
1011111000101
1100011011011
101110N101111
1000101000001
1000000010001
1100011000011
1010100100011
1000010011001
1111111111111