NO ./assets/debug_north.png
WE ./assets/debug_west.png
SO ./assets/debug_south.png
EA ./assets/debug_east.png

C 150,150,150
F 100,100,100

11111111111111
10000000100111
10000000000001
11000000010011
10000010000011
10000100011001
10000101010101
1001000N010011
10010010101011
11001011001011
10000001001001
11100001001001
11000000000001
11111111111111