NO ./assets/debug_north.png
WE ./assets/debug_west.png
SO ./assets/debug_south.png
EA ./assets/debug_east.png

C 150,150,150
F 100,100,100

1111111
1010001
1000011
101N001
1011101
1100011
1111111