NO ./assets/debug_north.png
WE ./assets/debug_west.png
SO ./assets/debug_south.png
EA ./assets/debug_east.png

C 150,150,150
F 100,100,100

111111111
100000101
100000001
111100001
1000N0011
110000001
100010001
100010001
111111111