NO ./assets/debug_north.png
WE ./assets/debug_west.png
SO ./assets/debug_south.png
EA ./assets/debug_east.png

C 150,150,150
F 100,100,100

11111111111
10100011001
11000001001
10110101011
10010000001
10000N00001
11000010101
10000110101
10101001101
11000011101
11111111111