NO ./assets/debug_north.png
WE ./assets/debug_west.png
SO ./assets/debug_south.png
EA ./assets/debug_east.png

C 150,150,150
F 100,100,100

111111111111
111100010101
100000100001
101010001001
100001011001
100100111001
100010N00011
100110000001
100000001011
100000010001
110011001001
111111111111