NO ./assets/debug_north.png
WE ./assets/debug_west.png
SO ./assets/debug_south.png
EA ./assets/debug_east.png

C 150,150,150
F 100,100,100

1111111111111
1110001100001
1000011000001
1010100001001
1000011011001
1011010000001
110001N001101
1001000000001
1000100011001
1110110000011
1100000010011
1110000010001
1111111111111