NO ./assets/debug_north.png
WE ./assets/debug_west.png
SO ./assets/debug_south.png
EA ./assets/debug_east.png

C 150,150,150
F 100,100,100

11111111111111
10101000010001
10000000101001
11000110001001
11100010100011
10000010101001
11000001001111
1000000N000101
10101000011001
10001101110001
10000100011001
11011000011101
11110110000011
11111111111111