NO ./assets/debug_north.png
WE ./assets/debug_west.png
SO ./assets/debug_south.png
EA ./assets/debug_east.png

C 150,150,150
F 100,100,100

1111111111
1000000001
1001001001
1101001011
1010100011
10010N0101
1100000101
1100000001
1111101001
1111111111