NO ./assets/debug_north.png
WE ./assets/debug_west.png
SO ./assets/debug_south.png
EA ./assets/debug_east.png

C 150,150,150
F 100,100,100

11111111111
10101000001
10010010101
10001110011
10100001001
11001N01111
10001010001
10000110001
11100001111
11000100101
11111111111