NO ./assets/debug_north.png
WE ./assets/debug_west.png
SO ./assets/debug_south.png
EA ./assets/debug_east.png

C 150,150,150
F 100,100,100

111111111111
101000010011
110100100001
110010001111
111001101101
110000101011
101000N01001
110010010101
100000011101
101000101001
100100010001
111111111111