NO ./assets/debug_north.png
WE ./assets/debug_west.png
SO ./assets/debug_south.png
EA ./assets/debug_east.png

C 150,150,150
F 100,100,100

1111111111111
1001010000011
1000000000001
1000001111001
1101001000001
1000111100001
100010N000101
1000101100001
1101000001111
1000100000111
1000010010001
1000000000001
1111111111111