NO ./assets/debug_north.png
WE ./assets/debug_west.png
SO ./assets/debug_south.png
EA ./assets/debug_east.png

C 150,150,150
F 100,100,100

11111111111111
10000010100101
11000011001001
10110000011101
10010000000011
11001100101001
10000000000111
1001100N001011
11001100000001
10010010000001
10001010001001
11001111000001
10010000000001
11111111111111