NO ./assets/debug_north.png
WE ./assets/debug_west.png
SO ./assets/debug_south.png
EA ./assets/debug_east.png

C 242,87,203
F 175,55,235

11111
10001
10N01
10001
11111