NO ./assets/debug_north.png
WE ./assets/debug_west.png
SO ./assets/debug_south.png
EA ./assets/debug_east.png

C 120,41,93
F 193,92,130

11111
10001
10N01
10001
11111