NO ./assets/debug_north.png
WE ./assets/debug_west.png
SO ./assets/debug_south.png
EA ./assets/debug_east.png

C 112,113,16
F 158,108,23

11111
10001
10N01
10001
11111