NO ./assets/debug_north.png
WE ./assets/debug_west.png
SO ./assets/debug_south.png
EA ./assets/debug_east.png

C 16,15,59
F 254,148,235

11111
10001
10N01
10001
11111