NO ./assets/debug_north.png
WE ./assets/debug_west.png
SO ./assets/debug_south.png
EA ./assets/debug_east.png

C 48,241,37
F 182,135,64

11111
10001
10N01
10001
11111