NO ./assets/debug_north.png
WE ./assets/debug_west.png
SO ./assets/debug_south.png
EA ./assets/debug_east.png

C 165,132,206
F 23,148,80

11111
10001
10N01
10001
11111