NO ./assets/debug_north.png
WE ./assets/debug_west.png
SO ./assets/debug_south.png
EA ./assets/debug_east.png

C 18,91,194
F 19,250,187

11111
10001
10N01
10001
11111