NO ./assets/debug_north.png
WE ./assets/debug_west.png
SO ./assets/debug_south.png
EA ./assets/debug_east.png

C 73,94,143
F 18,132,239

11111
10001
10N01
10001
11111