NO ./assets/debug_north.png
WE ./assets/debug_west.png
SO ./assets/debug_south.png
EA ./assets/debug_east.png

C 209,188,29
F 162,237,113

11111
10001
10N01
10001
11111