NO ./assets/debug_north.png
WE ./assets/debug_west.png
SO ./assets/debug_south.png
EA ./assets/debug_east.png

C 208,217,85
F 242,72,119

11111
10001
10N01
10001
11111