NO ./assets/debug_north.png
WE ./assets/debug_west.png
SO ./assets/debug_south.png
EA ./assets/debug_east.png

C 120,215,136
F 52,111,125

11111
10001
10N01
10001
11111