NO ./assets/debug_north.png
WE ./assets/debug_west.png
SO ./assets/debug_south.png
EA ./assets/debug_east.png

C 207,232,106
F 241,125,169

11111
10001
10N01
10001
11111