NO ./assets/debug_north.png
WE ./assets/debug_west.png
SO ./assets/debug_south.png
EA ./assets/debug_east.png

C 47,5,109
F 6,119,148

11111
10001
10N01
10001
11111