NO ./assets/debug_north.png
WE ./assets/debug_west.png
SO ./assets/debug_south.png
EA ./assets/debug_east.png

C 13,202,222
F 240,48,116

11111
10001
10N01
10001
11111