NO ./assets/debug_north.png
WE ./assets/debug_west.png
SO ./assets/debug_south.png
EA ./assets/debug_east.png

C 120,177,90
F 255,136,206

11111
10001
10N01
10001
11111