NO ./assets/debug_north.png
WE ./assets/debug_west.png
SO ./assets/debug_south.png
EA ./assets/debug_east.png

C 137,201,195
F 61,179,220

11111
10001
10N01
10001
11111