NO ./assets/debug_north.png
WE ./assets/debug_west.png
SO ./assets/debug_south.png
EA ./assets/debug_east.png

C 111,11,2
F 139,24,145

11111
10001
10N01
10001
11111