NO ./assets/debug_north.png
WE ./assets/debug_west.png
SO ./assets/debug_south.png
EA ./assets/debug_east.png

C 54,200,113
F 107,147,254

11111
10001
10N01
10001
11111