NO ./assets/debug_north.png
WE ./assets/debug_west.png
SO ./assets/debug_south.png
EA ./assets/debug_east.png

C 45,236,137
F 86,197,108

11111
10001
10N01
10001
11111