NO ./assets/debug_north.png
WE ./assets/debug_west.png
SO ./assets/debug_south.png
EA ./assets/debug_east.png

C 30,63,229
F 137,45,124

11111
10001
10N01
10001
11111