NO ./assets/debug_north.png
WE ./assets/debug_west.png
SO ./assets/debug_south.png
EA ./assets/debug_east.png

C 118,185,17
F 123,240,40

11111
10001
10N01
10001
11111