NO ./assets/debug_north.png
WE ./assets/debug_west.png
SO ./assets/debug_south.png
EA ./assets/debug_east.png

C 200,150,100
F 100,150,200

11111111
10000001
10111101
10E00001
10111101
10000001
11111111