NO ./assets/debug_north.png
WE ./assets/debug_west.png
SO ./assets/debug_south.png
EA ./assets/debug_east.png

C 200,150,100
F 100,150,200

1111111
1000001
1010101
10N0001
1010101
1000001
1111111