NO ./assets/debug_north.png
WE ./assets/debug_west.png
SO ./assets/debug_south.png
EA ./assets/debug_east.png

C 255,200,150
F 150,200,255

1111111111
1000000001
1000000001
1000000001
1000000001
10000W00001
1000000001
1000000001
1000000001
1111111111