NO ./assets/debug_north.png
WE ./assets/debug_west.png
SO ./assets/debug_south.png
EA ./assets/debug_east.png

C 255,200,150
F 150,200,255

11111111111
10000000001
10000000001
10000000001
10000000001
10000N000001
10000000001
10000000001
10000000001
10000000001
11111111111