NO ./assets/debug_north.png
WE ./assets/debug_west.png
SO ./assets/debug_south.png
EA ./assets/debug_east.png

C 255,0,0
F 0,0,255

11111
10*01
10N01
10001
11111