NO ./assets/debug_north.png
WE ./assets/debug_west.png
SO ./assets/debug_south.png
EA ./assets/debug_east.png

C 128,128,128
F 64,64,64

11111
10001
10S01
10001
11111