NO ./assets/debug_north.png
WE ./assets/debug_west.png
SO ./assets/debug_south.png
EA ./assets/debug_east.png

C 128,128,128
F 64,64,64

11111111111
10000000001
10111111101
10100000101
1010E010101
10100000101
10111111101
10000000001
11111111111