NO ./assets/debug_north.png
WE ./assets/debug_west.png
SO ./assets/debug_south.png
EA ./assets/debug_east.png

C 200,200,200
F 50,50,50

111111111111
100000000001
100000000001
100000000001
100000000001
100000000001
100000W000001
100000000001
100000000001
100000000001
100000000001
111111111111