NO ./assets/debug_north.png
WE ./assets/debug_west.png
SO ./assets/debug_south.png
EA ./assets/debug_east.png

C 128,128,128
F 64,64,64

1111111
1000001
1000001
100E0001
1000001
1000001
1111111