NO ./assets/debug_north.png
WE ./assets/debug_west.png
SO ./assets/debug_south.png
EA ./assets/debug_east.png

C 255,128,0
F 0,128,255

111111111
100000001
100000001
100000001
1000N00001
100000001
100000001
100000001
111111111