NO ./assets/debug_north.png
WE ./assets/debug_west.png
SO ./assets/debug_south.png
EA ./assets/debug_east.png

C 128,128,128
F 64,64,64

111111111111
100000000001
100000000001
100000000001
100000000001
100000000001
100000W000001
100000000001
100000000001
100000000001
100000000001
111111111111