NO ./assets/debug_north.png
WE ./assets/debug_west.png
SO ./assets/debug_south.png
EA ./assets/debug_east.png

C 255,255,255
F 0,0,0

1111111111111111111111111111111111111111111
1000000000000000000000000000000000000000001
1000000000000000000000000000000000000000001
1000000000000000000000000000000000000000001
1000000000000000000000000000000000000000001
1000000000000000000000000000000000000000001
1000000000000000000000000000000000000000001
1000000000000000000000000000000000000000001
1000000000000000000000000000000000000000001
1000000000000000000000000000000000000000001
1000000000000000000000000000000000000000001
1000000000000000000000000000000000000000001
1000000000000000000000000000000000000000001
1000000000000000000000000000000000000000001
1000000000000000000000000000000000000000001
1000000000000000000000000000000000000000001
1000000000000000000000000000000000000000001
1000000000000000000000000000000000000000001
1000000000000000000000000000000000000000001
1000000000000000000000000000000000000000001
1000000000000000000000000000000000000000001
100000000000000000000N000000000000000000001
1000000000000000000000000000000000000000001
1000000000000000000000000000000000000000001
1000000000000000000000000000000000000000001
1000000000000000000000000000000000000000001
1000000000000000000000000000000000000000001
1000000000000000000000000000000000000000001
1000000000000000000000000000000000000000001
1000000000000000000000000000000000000000001
1000000000000000000000000000000000000000001
1000000000000000000000000000000000000000001
1000000000000000000000000000000000000000001
1000000000000000000000000000000000000000001
1000000000000000000000000000000000000000001
1000000000000000000000000000000000000000001
1000000000000000000000000000000000000000001
1000000000000000000000000000000000000000001
1000000000000000000000000000000000000000001
1000000000000000000000000000000000000000001
1000000000000000000000000000000000000000001
1000000000000000000000000000000000000000001
1111111111111111111111111111111111111111111