NO ./assets/debug_north.png
WE ./assets/debug_west.png
SO ./assets/debug_south.png
EA ./assets/debug_east.png

C 69,94,82
F 89,18,10

11111
10001
10N01
10001
11111