NO ./assets/debug_north.png
WE ./assets/debug_west.png
SO ./assets/debug_south.png
EA ./assets/debug_east.png

C 227,186,210
F 59,19,177

11111
10001
10W01
10001
11111