NO ./assets/debug_north.png
WE ./assets/debug_west.png
SO ./assets/debug_south.png
EA ./assets/debug_east.png

C 127,171,89
F 106,194,29

11111
10001
10S01
10001
11111