NO ./assets/debug_north.png
WE ./assets/debug_west.png
SO ./assets/debug_south.png
EA ./assets/debug_east.png

C 173,234,33
F 27,32,227

11111
10001
10E01
10001
11111