NO ./assets/debug_north.png
WE ./assets/debug_west.png
SO ./assets/debug_south.png
EA ./assets/debug_east.png

C 144,234,247
F 74,58,156

11111
10001
10W01
10001
11111