NO ./assets/debug_north.png
WE ./assets/debug_west.png
SO ./assets/debug_south.png
EA ./assets/debug_east.png

C 122,29,96
F 156,175,128

11111
10001
10N01
10001
11111