NO ./assets/debug_north.png
WE ./assets/debug_west.png
SO ./assets/debug_south.png
EA ./assets/debug_east.png

C 9,30,96
F 100,37,184

11111
10001
10S01
10001
11111