NO ./assets/debug_north.png
WE ./assets/debug_west.png
SO ./assets/debug_south.png
EA ./assets/debug_east.png

C 68,242,243
F 92,123,184

11111
10001
10W01
10001
11111