NO ./assets/debug_north.png
WE ./assets/debug_west.png
SO ./assets/debug_south.png
EA ./assets/debug_east.png

C 1,89,164
F 187,18,136

11111
10001
10S01
10001
11111