NO ./assets/debug_north.png
WE ./assets/debug_west.png
SO ./assets/debug_south.png
EA ./assets/debug_east.png

C 59,58,7
F 243,71,212

11111
10001
10N01
10001
11111