NO ./assets/debug_north.png
WE ./assets/debug_west.png
SO ./assets/debug_south.png
EA ./assets/debug_east.png

C 22,227,251
F 196,75,16

11111
10001
10S01
10001
11111