NO ./assets/debug_north.png
WE ./assets/debug_west.png
SO ./assets/debug_south.png
EA ./assets/debug_east.png

C 166,115,49
F 175,168,101

11111
10001
10E01
10001
11111