NO ./assets/debug_north.png
WE ./assets/debug_west.png
SO ./assets/debug_south.png
EA ./assets/debug_east.png

C 135,43,97
F 28,81,221

11111
10001
10W01
10001
11111