NO ./assets/debug_north.png
WE ./assets/debug_west.png
SO ./assets/debug_south.png
EA ./assets/debug_east.png

C 221,134,177
F 155,29,86

11111
10001
10S01
10001
11111