NO ./assets/debug_north.png
WE ./assets/debug_west.png
SO ./assets/debug_south.png
EA ./assets/debug_east.png

C 66,6,147
F 167,254,240

11111
10001
10W01
10001
11111