NO ./assets/debug_north.png
WE ./assets/debug_west.png
SO ./assets/debug_south.png
EA ./assets/debug_east.png

C 51,50,194
F 3,143,249

11111
10001
10S01
10001
11111