NO ./assets/debug_north.png
WE ./assets/debug_west.png
SO ./assets/debug_south.png
EA ./assets/debug_east.png

C 255,128,0
F 0,128,255

1111111111111111111111111
1000000000110000000000001
1011000001110000000000001
1001000000000000000000001
1111111111110000011111001
1000000000000000000001001
1000000000000000000001001
1000000000000000000001001
1000000000000000000001001
1000000000000000000001001
10000N0000000000000001001
1000000000000000000001001
1000000000000000000001001
1000000000000000000001001
1000000000000000000001001
1000000000000000000001001
1111111111110000011111001
1000000000000000000000001
1000000000000000000000001
1000000000000000000000001
1111111111111111111111111
