NO ./assets/debug_north.png
WE ./assets/debug_west.png
SO ./assets/debug_south.png
EA ./assets/debug_east.png

C 0,58,213
F 227,26,221

11111
10001
10N01
10001
11111