NO ./assets/debug_north.png
WE ./assets/debug_west.png
SO ./assets/debug_south.png
EA ./assets/debug_east.png

C 44,23,46
F 211,180,228

11111
10001
10N01
10001
11111