NO ./assets/debug_north.png
WE ./assets/debug_west.png
SO ./assets/debug_south.png
EA ./assets/debug_east.png

C 15,31,115
F 113,51,58

11111
10001
10N01
10001
11111