NO ./assets/debug_north.png
WE ./assets/debug_west.png
SO ./assets/debug_south.png
EA ./assets/debug_east.png

C 10,248,50
F 248,147,7

11111
10001
10N01
10001
11111