NO ./assets/debug_north.png
WE ./assets/debug_west.png
SO ./assets/debug_south.png
EA ./assets/debug_east.png

C 227,203,205
F 255,54,199

11111
10001
10N01
10001
11111