NO ./assets/debug_north.png
WE ./assets/debug_west.png
SO ./assets/debug_south.png
EA ./assets/debug_east.png

C 251,132,145
F 98,217,92

11111
10001
10N01
10001
11111