NO ./assets/debug_north.png
WE ./assets/debug_west.png
SO ./assets/debug_south.png
EA ./assets/debug_east.png

C 10,3,162
F 163,78,22

11111
10001
10N01
10001
11111