NO ./assets/debug_north.png
WE ./assets/debug_west.png
SO ./assets/debug_south.png
EA ./assets/debug_east.png

C 81,215,134
F 95,93,173

11111
10001
10N01
10001
11111