NO ./assets/debug_north.png
WE ./assets/debug_west.png
SO ./assets/debug_south.png
EA ./assets/debug_east.png

C 9,82,157
F 100,157,204

11111
10001
10N01
10001
11111