NO ./assets/debug_north.png
WE ./assets/debug_west.png
SO ./assets/debug_south.png
EA ./assets/debug_east.png

C 40,38,92
F 240,107,232

11111
10001
10N01
10001
11111