NO ./assets/debug_north.png
WE ./assets/debug_west.png
SO ./assets/debug_south.png
EA ./assets/debug_east.png

C 0,0,255
F 0,255,0

11111
1XYZ1
10N01
1ABC1
11111
