NO ./assets/debug_north.png
WE ./assets/debug_west.png
SO ./assets/debug_south.png
EA ./assets/debug_east.png

C 128,200,255
F 255,200,128

111111111111111
100000000000001
100000000000001
100000000000001
100000000000001
100000000000001
100000000000001
1000000E00000001
100000000000001
100000000000001
100000000000001
100000000000001
100000000000001
100000000000001
111111111111111