NO ./assets/debug_north.png
WE ./assets/debug_west.png
SO ./assets/debug_south.png
EA ./assets/debug_east.png

C 128,200,255
F 255,200,128

11111111111
10001000001
10101010101
10001000001
1000W000001
10001000001
10101010101
10001000001
11111111111