NO ./assets/debug_north.png
WE ./assets/debug_west.png
SO ./assets/debug_south.png
EA ./assets/debug_east.png

C 221,232,38
F 167,220,150

11111
10001
10N01
10001
11111