NO ./assets/debug_north.png
WE ./assets/debug_west.png
SO ./assets/debug_south.png
EA ./assets/debug_east.png

C 246,52,66
F 58,214,200

11111
10001
10N01
10001
11111