NO ./assets/debug_north.png
WE ./assets/debug_west.png
SO ./assets/debug_south.png
EA ./assets/debug_east.png

C 161,174,141
F 251,35,40

11111
10001
10N01
10001
11111