NO ./assets/debug_north.png
WE ./assets/debug_west.png
SO ./assets/debug_south.png
EA ./assets/debug_east.png

C 3,23,88
F 0,4,63

11111
10001
10N01
10001
11111