NO ./assets/debug_north.png
WE ./assets/debug_west.png
SO ./assets/debug_south.png
EA ./assets/debug_east.png

C 90,153,252
F 44,150,137

11111
10001
10N01
10001
11111