NO ./assets/debug_north.png
WE ./assets/debug_west.png
SO ./assets/debug_south.png
EA ./assets/debug_east.png

C 101,45,79
F 252,153,234

11111
10001
10N01
10001
11111