NO ./assets/debug_north.png
WE ./assets/debug_west.png
SO ./assets/debug_south.png
EA ./assets/debug_east.png

C 215,61,26
F 33,49,37

11111
10001
10N01
10001
11111