NO ./assets/debug_north.png
WE ./assets/debug_west.png
SO ./assets/debug_south.png
EA ./assets/debug_east.png

C 138,188,98
F 104,203,30

11111
10001
10N01
10001
11111