NO ./assets/debug_north.png
WE ./assets/debug_west.png
SO ./assets/debug_south.png
EA ./assets/debug_east.png

C 245,91,74
F 50,126,133

11111
10001
10N01
10001
11111