NO /absolute/path/north.png
WE ./assets/debug_west.png
SO ./assets/debug_south.png
EA ./assets/debug_east.png

C 181,114,151
F 183,12,107

11111
10001
10N01
10001
11111