NO texture.xpm
WE ./assets/debug_west.png
SO ./assets/debug_south.png
EA ./assets/debug_east.png

C 79,147,189
F 135,161,225

11111
10001
10N01
10001
11111