NO ./assets/debug_north.png
WE ./assets/debug_west.png
SO ./assets/debug_south.png
EA ./assets/debug_east.png

C 97,112,172
F 95,126,42

11111
10001
10N01
10001
11111