NO ./assets/textures/wall_north.png
WE ./assets/debug_west.png
SO ./assets/debug_south.png
EA ./assets/debug_east.png

C 130,200,152
F 122,9,84

11111
10001
10N01
10001
11111