NO /absolute/path/north.png
WE ./assets/debug_west.png
SO ./assets/debug_south.png
EA ./assets/debug_east.png

C 73,112,40
F 254,245,51

11111
10001
10N01
10001
11111