NO ../relative/north.png
WE ./assets/debug_west.png
SO ./assets/debug_south.png
EA ./assets/debug_east.png

C 126,68,105
F 199,255,164

11111
10001
10N01
10001
11111