NO texture.xpm
WE ./assets/debug_west.png
SO ./assets/debug_south.png
EA ./assets/debug_east.png

C 247,122,48
F 135,43,155

11111
10001
10N01
10001
11111