NO ./assets/debug_north.png
WE ./assets/debug_west.png
SO ./assets/debug_south.png
EA ./assets/debug_east.png

C 214,152,143
F 172,215,143

11111
10001
10N01
10001
11111