NO ./assets/debug_north.png
WE ./assets/debug_west.png
SO ./assets/debug_south.png
EA ./assets/debug_east.png

C 112,186,33
F 16,99,17

11111
10001
10N01
10001
11111