NO ./assets/debug_north.png
WE ./assets/debug_west.png
SO ./assets/debug_south.png
EA ./assets/debug_east.png

C 119,14,211
F 189,177,252

11111
10001
10N01
10001
11111