NO ./assets/debug_north.png
WE ./assets/debug_west.png
SO ./assets/debug_south.png
EA ./assets/debug_east.png

C 212,126,88
F 91,191,254

11111
10001
10N01
10001
11111