NO ./assets/debug_north.png
WE ./assets/debug_west.png
SO ./assets/debug_south.png
EA ./assets/debug_east.png

C 173,41,50
F 141,106,221

11111
10001
10N01
10001
11111