NO ./assets/debug_north.png
WE ./assets/debug_west.png
SO ./assets/debug_south.png
EA ./assets/debug_east.png

C 194,127,79
F 31,112,89

11111
10001
10N01
10001
11111