NO ./assets/debug_north.png
WE ./assets/debug_west.png
SO ./assets/debug_south.png
EA ./assets/debug_east.png

C 168,100,79
F 8,60,167

11111
10001
10N01
10001
11111