NO ./assets/debug_north.png
WE ./assets/debug_west.png
SO ./assets/debug_south.png
EA ./assets/debug_east.png

C 148,18,201
F 135,236,36

11111
10001
10N01
10001
11111