NO ./assets/debug_north.png
WE ./assets/debug_west.png
SO ./assets/debug_south.png
EA ./assets/debug_east.png

C 61,99,91
F 206,86,159

11111
10001
10N01
10001
11111