NO ./assets/debug_north.png
WE ./assets/debug_west.png
SO ./assets/debug_south.png
EA ./assets/debug_east.png

C 12,170,72
F 248,203,30

11111
10001
10N01
10001
11111