NO ./assets/debug_north.png
WE ./assets/debug_west.png
SO ./assets/debug_south.png
EA ./assets/debug_east.png

C 232,32,172
F 136,33,60

11111
10001
10N01
10001
11111