NO ./assets/debug_north.png
WE ./assets/debug_west.png
SO ./assets/debug_south.png
EA ./assets/debug_east.png

C 0,0,255
F 0,255,0

1111111111111111111111111111111111111111111111111
1000000000100000000010000000001000000000100000001
1011111110101111111010111111101011111110101111101
1010000000101000000010100000001010000000101000001
1010111110101011111010101111101010111110101011101
1010100000101010000010101000001010100000101010001
1010101111101010111110101011111010101111101010111
1010101000001010100000101010000010101000001010101
1010101011111010101111101010111110101011111010101
1010101010000010101000001010100000101010000010101
1010101010111110101011111010101111101010111110101
1010101010100000101010000010101000001010100000101
1010101010101111101010111110101011111010101111101
1010101010101000001010100000101010000010101000001
1010101010101011111010101111101010111110101011111
1010101010101010000010101000001010100000101010001
1010101010101010111110101011111010101111101010111
1010101010101010100000101010000010101000001010101
1010101010101010101111101010111110101011111010101
1010101010101010101000001010100000101010000010101
1010101010101010101011111010101111101010111110101
1000101010101010101010000010101000001010100000101
1111101010101010101010111110101011111010101111101
1000001010101010101010100000101010000010101000001
1011111010101010101010101111101010111110101011111
1010000010101010101010101000001010100000101010001
1010111110101010101010101011111010101111101010111
1010100000101010101010101010000010101000001010101
1010101111101010101010101010111110101011111010101
1010101000001010101010101010100000101010000010101
1010101011111010101010101010101111101010111110101
1010101010000010101010101010101000001010100000101
1010101010111110101010101010101011111010101111101
1010101010100000101010101010101010000010101000001
1010101010101111101010101010101010111110101011111
1010101010101000001010101010101010100000101010001
1010101010101011111010101010101010101111101010111
1010101010101010000010101010101010101000001010101
1010101010101010111110101010101010101011111010101
1010101010101010100000101010101010101010000010101
1010101010101010101111101010101010101010111110101
1000101010101010101000001010101010101010100000101
1111101010101010101011111010101010101010101111101
1000001010101010101010000010101010101010101000001
1011111010101010101010111110101010101010101011111
1010000010101010101010100000101010101010101010001
1010111110101010101010101111101010101010101010111
1010100000101010101010101000001010101010101010101
1010101111101010101010101011111010101010101010101
1010101000001010101010101010000010101010101010101
1010101011111010101010101010111110101010101010101
1010101010000010101010101010100000101010101010101
1010101010111110101010101010101111101010101010101
1010101010100000101010101010101000001010101010101
1010101010101111101010101010101011111010101010101
1010101010101000001010101010101010000010101010101
1010101010101011111010101010101010111110101010101
1010101010101010000010101010101010100000101010101
1010101010101010111110101010101010101111101010101
1010101010101010100000101010101010101000001010101
1010101010101010101111101010101010101011111010101
1010101010101010101000001010101010101010000010101
1010101010101010101011111010101010101010111110101
1000101010101010101010000010101010101010100000101
1111101010101010101010111110101010101010101111101
1000001010101010101010100000101010101010101000001
1011111010101010101010101111101010101010101011111
1010000010101010101010101000001010101010101010001
1010111110101010101010101011111010101010101010111
1010100000101010101010101010000010101010101010101
1010101111101010101010101010111110101010101010101
1010101000001010101010101010100000101010101010101
1010101011111010101010101010101111101010101010101
1010101010000010101010101010101000001010101010101
1010101010111110101010101010101011111010101010101
1010101010100000101010101010101010000010101010101
1010101010101111101010101010101010111110101010101
1010101010101000001010101010101010100000101010101
1010101010101011111010101010101010101111101010101
1010101010101010000010101010101010101000001010101
1010101010101010111110101010101010101011111010101
1010101010101010100000101010101010101010000010101
1010101010101010101111101010101010101010111110101
1010101010101010101000001010101010101010100000101
1010101010101010101011111010101010101010101111101
1000101010101010101010000010101010101010101000001
1111101010101010101010111110101010101010101011111
1000001010101010101010100000101010101010101010001
1011111010101010101010101111101010101010101010111
1010000010101010101010101000001010101010101010101
1010111110101010101010101011111010101010101010101
1010100000101010101010101010000010101010101010101
1010101111101010101010101010111110101010101010101
1010101000001010101010101010100000101010101010101
1010101011111010101010101010101111101010101010101
1010101010000010101010101010101000001010101010101
1010101010111110101010101010101011111010101010101
1010101010100000101010101010101010000010101010101
1010101010101111101010101010101010111110101010101
1010101010101000001010101010101010100000101010101
1010101010101011111010101010101010101111101010101
1010101010101010000010101010101010101000001010101
1010101010101010111110101010101010101011111010101
1010101010101010100000101010101010101010000010101
1010101010101010101111101010101010101010111110101
1000000000000000000000000000000000000000000000001
1111111111111111111111111111111111111111111111111
