NO ./assets/debug_north.png
WE ./assets/debug_west.png
SO ./assets/debug_south.png
EA ./assets/debug_east.png

C 100,150,200
F 50,100,150

111111111
100010001
1N0010001
100010001
111111111