NO ./assets/debug_north.png
WE ./assets/debug_west.png
SO ./assets/debug_south.png
EA ./assets/debug_east.png

C 100,150,200
F 50,100,150

1111111111
1000000001
1000000001
1000N00001
1000000001
1000000001
1111111111