NO ./assets/debug_north.png
WE ./assets/debug_west.png
SO ./assets/debug_south.png
EA ./assets/debug_east.png

C 100,150,200
F 50,100,150

11111
10001
10N001
10001
11111