NO ./assets/debug_north.png
WE ./assets/debug_west.png
SO ./assets/debug_south.png
EA ./assets/debug_east.png

C 85,39,143
F 145,48,219

11111
10001
10N01
10001
11111