NO ./assets/debug_north.png
WE ./assets/debug_west.png
SO ./assets/debug_south.png
EA ./assets/debug_east.png

C 252,170,104
F 218,176,102

11111
10001
10N01
10001
11111