NO ./assets/debug_north.png
WE ./assets/debug_west.png
SO ./assets/debug_south.png
EA ./assets/debug_east.png

C 154,215,77
F 219,175,85

11111
10001
10N01
10001
11111