NO ./assets/debug_north.png
WE ./assets/debug_west.png
SO ./assets/debug_south.png
EA ./assets/debug_east.png

C 213,174,217
F 171,186,65

11111
10001
10N01
10001
11111