NO ./assets/debug_north.png
WE ./assets/debug_west.png
SO ./assets/debug_south.png
EA ./assets/debug_east.png

C 50,25,19
F 91,97,163

11111
10001
10N01
10001
11111