NO ./assets/debug_north.png
WE ./assets/debug_west.png
SO ./assets/debug_south.png
EA ./assets/debug_east.png

C 230,51,149
F 14,48,23

11111
10001
10N01
10001
11111