NO ./assets/debug_north.png
WE ./assets/debug_west.png
SO ./assets/debug_south.png
EA ./assets/debug_east.png

C 150,166,209
F 119,41,78

11111
10001
10N01
10001
11111