NO ./assets/debug_north.png
WE ./assets/debug_west.png
SO ./assets/debug_south.png
EA ./assets/debug_east.png

C 44,208,212
F 109,221,103

11111
10001
10N01
10001
11111