NO ./assets/debug_north.png
WE ./assets/debug_west.png
SO ./assets/debug_south.png
EA ./assets/debug_east.png

C 189,36,31
F 185,180,210

11111
10001
10N01
10001
11111