NO ./assets/debug_north.png
WE ./assets/debug_west.png
SO ./assets/debug_south.png
EA ./assets/debug_east.png

C 152,135,62
F 229,123,247

11111
10001
10N01
10001
11111