NO ./assets/debug_north.png
WE ./assets/debug_west.png
SO ./assets/debug_south.png
EA ./assets/debug_east.png

C 41,39,215
F 208,120,62

11111
10001
10N01
10001
11111