NO ./assets/debug_north.png
WE ./assets/debug_west.png
SO ./assets/debug_south.png
EA ./assets/debug_east.png

C 65,52,181
F 224,54,95

11111
10001
10N01
10001
11111