NO ./assets/debug_north.png
WE ./assets/debug_west.png
SO ./assets/debug_south.png
EA ./assets/debug_east.png

C 126,238,123
F 8,97,145

11111
10001
10N01
10001
11111