NO ./assets/debug_north.png
WE ./assets/debug_west.png
SO ./assets/debug_south.png
EA ./assets/debug_east.png

C 116,104,184
F 137,3,2

11111
10001
10N01
10001
11111