NO ./assets/debug_north.png
WE ./assets/debug_west.png
SO ./assets/debug_south.png
EA ./assets/debug_east.png

C 33,254,182
F 88,179,48

11111
10001
10N01
10001
11111