NO ./assets/debug_north.png
WE ./assets/debug_west.png
SO ./assets/debug_south.png
EA ./assets/debug_east.png

C 237,43,76
F 204,25,111

11111
10001
10N01
10001
11111