NO ./assets/debug_north.png
WE ./assets/debug_west.png
SO ./assets/debug_south.png
EA ./assets/debug_east.png

C 200,166,21
F 209,146,60

11111
10001
10N01
10001
11111