NO ./assets/debug_north.png
WE ./assets/debug_west.png
SO ./assets/debug_south.png
EA ./assets/debug_east.png

C 155,16,137
F 129,62,120

11111
10001
10N01
10001
11111