NO ./assets/debug_north.png
WE ./assets/debug_west.png
SO ./assets/debug_south.png
EA ./assets/debug_east.png

C 226,188,47
F 67,23,142

11111
10001
10N01
10001
11111