NO ./assets/debug_north.png
WE ./assets/debug_west.png
SO ./assets/debug_south.png
EA ./assets/debug_east.png

C 50,58,93
F 117,187,59

11111
10001
10N01
10001
11111