NO ./assets/debug_north.png
WE ./assets/debug_west.png
SO ./assets/debug_south.png
EA ./assets/debug_east.png

C 222,139,237
F 215,17,200

11111
10001
10N01
10001
11111