NO ./assets/debug_north.png
WE ./assets/debug_west.png
SO ./assets/debug_south.png
EA ./assets/debug_east.png

C 175,164,218
F 175,127,61

11111
10001
10N01
10001
11111