NO ./assets/debug_north.png
WE ./assets/debug_west.png
SO ./assets/debug_south.png
EA ./assets/debug_east.png

C 164,92,85
F 241,97,95

11111
10001
10N01
10001
11111