NO ./assets/debug_north.png
WE ./assets/debug_west.png
SO ./assets/debug_south.png
EA ./assets/debug_east.png

C 228,134,8
F 243,75,5

11111
10001
10N01
10001
11111