NO ./assets/debug_north.png
WE ./assets/debug_west.png
SO ./assets/debug_south.png
EA ./assets/debug_east.png

C 212,24,161
F 119,123,113

11111
10001
10N01
10001
11111