NO ./assets/debug_north.png
WE ./assets/debug_west.png
SO ./assets/debug_south.png
EA ./assets/debug_east.png

C 182,163,220
F 168,169,209

11111
10001
10N01
10001
11111