NO ./assets/debug_north.png
WE ./assets/debug_west.png
SO ./assets/debug_south.png
EA ./assets/debug_east.png

C 37,125,244
F 32,178,0

11111
10001
10E01
10001
11111