NO ./assets/debug_north.png
WE ./assets/debug_west.png
SO ./assets/debug_south.png
EA ./assets/debug_east.png

C 20,14,207
F 13,196,5

11111
10001
10S01
10001
11111