NO ./assets/debug_north.png
WE ./assets/debug_west.png
SO ./assets/debug_south.png
EA ./assets/debug_east.png

C 78,139,214
F 58,233,47

11111
10001
10W01
10001
11111