NO ./assets/debug_north.png
WE ./assets/debug_west.png
SO ./assets/debug_south.png
EA ./assets/debug_east.png

C 160,175,58
F 126,213,90

11111
10001
10N01
10001
11111