NO ./assets/debug_north.png
WE ./assets/debug_west.png
SO ./assets/debug_south.png
EA ./assets/debug_east.png

C 3,183,8
F 90,78,103

11111
10001
10N01
10001
11111