NO ./assets/debug_north.png
WE ./assets/debug_west.png
SO ./assets/debug_south.png
EA ./assets/debug_east.png

C 29,94,20
F 160,191,23

11111
10001
10E01
10001
11111