NO ./assets/debug_north.png
WE ./assets/debug_west.png
SO ./assets/debug_south.png
EA ./assets/debug_east.png

C 88,29,243
F 92,147,175

11111
10001
10W01
10001
11111