NO ./assets/debug_north.png
WE ./assets/debug_west.png
SO ./assets/debug_south.png
EA ./assets/debug_east.png

C 82,45,202
F 31,128,88

11111
10001
10N01
10001
11111