NO ./assets/debug_north.png
WE ./assets/debug_west.png
SO ./assets/debug_south.png
EA ./assets/debug_east.png

C 97,178,219
F 10,12,234

11111
10001
10S01
10001
11111