NO ./assets/debug_north.png
WE ./assets/debug_west.png
SO ./assets/debug_south.png
EA ./assets/debug_east.png

C 25,238,174
F 249,180,138

11111
10001
10E01
10001
11111