NO ./assets/debug_north.png
WE ./assets/debug_west.png
SO ./assets/debug_south.png
EA ./assets/debug_east.png

C 226,102,61
F 232,152,135

11111
10001
10W01
10001
11111