NO ./assets/debug_north.png
WE ./assets/debug_west.png
SO ./assets/debug_south.png
EA ./assets/debug_east.png

C 97,252,71
F 169,108,118

11111
10001
10E01
10001
11111