NO ./assets/debug_north.png
WE ./assets/debug_west.png
SO ./assets/debug_south.png
EA ./assets/debug_east.png

C 34,211,6
F 10,192,185

11111
10001
10N01
10001
11111