NO ./assets/debug_north.png
WE ./assets/debug_west.png
SO ./assets/debug_south.png
EA ./assets/debug_east.png

C 184,221,164
F 11,81,255

11111
10001
10E01
10001
11111