NO ./assets/debug_north.png
WE ./assets/debug_west.png
SO ./assets/debug_south.png
EA ./assets/debug_east.png

C 88,224,50
F 251,86,76

11111
10001
10N01
10001
11111