NO ./assets/debug_north.png
WE ./assets/debug_west.png
SO ./assets/debug_south.png
EA ./assets/debug_east.png

C 138,83,119
F 9,146,212

11111
10001
10S01
10001
11111