NO ./assets/debug_north.png
WE ./assets/debug_west.png
SO ./assets/debug_south.png
EA ./assets/debug_east.png

C 196,217,133
F 59,61,200

11111
10001
10E01
10001
11111