NO ./assets/debug_north.png
WE ./assets/debug_west.png
SO ./assets/debug_south.png
EA ./assets/debug_east.png

C 30,40,231
F 161,81,82

11111
10001
10W01
10001
11111