NO ./assets/debug_north.png
WE ./assets/debug_west.png
SO ./assets/debug_south.png
EA ./assets/debug_east.png

C 69,216,108
F 169,251,81

11111
10001
10N01
10001
11111