NO ./assets/debug_north.png
WE ./assets/debug_west.png
SO ./assets/debug_south.png
EA ./assets/debug_east.png

C 41,12,108
F 41,70,163

11111
10001
10W01
10001
11111