NO ./assets/debug_north.png
WE ./assets/debug_west.png
SO ./assets/debug_south.png
EA ./assets/debug_east.png

C 229,34,30
F 234,61,138

11111
10001
10N01
10001
11111