NO ./assets/debug_north.png
WE ./assets/debug_west.png
SO ./assets/debug_south.png
EA ./assets/debug_east.png

C 10,218,243
F 171,195,93

11111
10001
10S01
10001
11111