NO ./assets/debug_north.png
WE ./assets/debug_west.png
SO ./assets/debug_south.png
EA ./assets/debug_east.png

C 222,251,95
F 126,99,182

11111
10001
10W01
10001
11111