NO ./assets/debug_north.png
WE ./assets/debug_west.png
SO ./assets/debug_south.png
EA ./assets/debug_east.png

C 104,118,67
F 138,13,15

11111
10001
10N01
10001
11111