NO ./assets/debug_north.png
WE ./assets/debug_west.png
SO ./assets/debug_south.png
EA ./assets/debug_east.png

C 72,143,30
F 227,221,245

11111
10001
10S01
10001
11111