NO ./assets/debug_north.png
WE ./assets/debug_west.png
SO ./assets/debug_south.png
EA ./assets/debug_east.png

C 98,111,168
F 114,175,65

11111
10001
10E01
10001
11111