NO ./assets/debug_north.png
WE ./assets/debug_west.png
SO ./assets/debug_south.png
EA ./assets/debug_east.png

C 150,255,150
F 255,150,255

1111111
1000001
100N001
1000001
1111111