NO ./assets/debug_north.png
WE ./assets/debug_west.png
SO ./assets/debug_south.png
EA ./assets/debug_east.png

C 128,255,128
F 255,128,255

1111111
1000001
1011101
10S0001
1011101
1000001
1111111