NO ./assets/debug_north.png
WE ./assets/debug_west.png
SO ./assets/debug_south.png
EA ./assets/debug_east.png

C 152,41,121
F 53,129,69

11111
10001
10N01
10001
11111