NO ./assets/debug_north.png
WE ./assets/debug_west.png
SO ./assets/debug_south.png
EA ./assets/debug_east.png

C 85,71,65
F 221,224,112

11111
10001
10N01
10001
11111