NO ./assets/debug_north.png
WE ./assets/debug_west.png
SO ./assets/debug_south.png
EA ./assets/debug_east.png

C 223,133,242
F 62,127,13

11111
10001
10N01
10001
11111