NO ./assets/debug_north.png
WE ./assets/debug_west.png
SO ./assets/debug_south.png
EA ./assets/debug_east.png

C 255,73,229
F 32,56,12

11111
10001
10N01
10001
11111