NO 255,255,255
WE 255,0,0
SO 0,255,0
EA 0,0,255

F 255,100,0
C 225,0,0
11111111111
10001010001
1000P0P0001
1111111PP11
10101010001
1010000N001
11111111111 0P