NO ./assets/debug_north.png
WE ./assets/debug_west.png
SO ./assets/debug_south.png
EA ./assets/debug_east.png

C 170,251,248
F 36,247,77

11111
10001
10W01
10001
11111