NO ./assets/debug_north.png
WE ./assets/debug_west.png
SO ./assets/debug_south.png
EA ./assets/debug_east.png

C 124,70,78
F 53,6,156

11111
10001
10N01
10001
11111