NO ./assets/debug_north.png
WE ./assets/debug_west.png
SO ./assets/debug_south.png
EA ./assets/debug_east.png

C 68,131,184
F 14,71,242

11111
10001
10S01
10001
11111