NO ./assets/debug_north.png
WE ./assets/debug_west.png
SO ./assets/debug_south.png
EA ./assets/debug_east.png

C 221,210,206
F 198,210,172

11111
10001
10E01
10001
11111