NO ./assets/debug_north.png
WE ./assets/debug_west.png
SO ./assets/debug_south.png
EA ./assets/debug_east.png

C 246,161,32
F 52,231,193

11111
10001
10E01
10001
11111