NO ./assets/debug_north.png
WE ./assets/debug_west.png
SO ./assets/debug_south.png
EA ./assets/debug_east.png

C 164,31,110
F 29,30,188

11111
10001
10S01
10001
11111