NO ./assets/debug_north.png
WE ./assets/debug_west.png
SO ./assets/debug_south.png
EA ./assets/debug_east.png

C 15,179,239
F 58,225,75

11111
10001
10E01
10001
11111