NO ./assets/debug_north.png
WE ./assets/debug_west.png
SO ./assets/debug_south.png
EA ./assets/debug_east.png

C 92,149,112
F 68,68,225

11111
10001
10W01
10001
11111