NO ./assets/debug_north.png
WE ./assets/debug_west.png
SO ./assets/debug_south.png
EA ./assets/debug_east.png

C 0,119,198
F 165,102,229

11111
10001
10S01
10001
11111