NO ./assets/debug_north.png
WE ./assets/debug_west.png
SO ./assets/debug_south.png
EA ./assets/debug_east.png

C 23,0,185
F 193,250,109

11111
10001
10N01
10001
11111