NO ./assets/debug_north.png
WE ./assets/debug_west.png
SO ./assets/debug_south.png
EA ./assets/debug_east.png

C 128,128,255
F 255,128,128

1111111
1000001
1000001
100S0001
1000001
1000001
1111111