NO ./assets/debug_north.png
WE ./assets/debug_west.png
SO ./assets/debug_south.png
EA ./assets/debug_east.png

C 200,150,100
F 40,30,20

11111111111
10000000001
10000000001
10000000001
10000000001
10000W000001
10000000001
10000000001
10000000001
10000000001
11111111111