NO ./assets/debug_north.png
WE ./assets/debug_west.png
SO ./assets/debug_south.png
EA ./assets/debug_east.png

C 200,150,100
F 40,30,20

1111111111111
1000000000001
1000000000001
1000000000001
1000000000001
1000000000001
100000W0000001
1000000000001
1000000000001
1000000000001
1000000000001
1000000000001
1111111111111