NO ./assets/debug_north.png
WE ./assets/debug_west.png
SO ./assets/debug_south.png
EA ./assets/debug_east.png

C 150,150,150
F 30,30,30

11111111
10000001
10000001
10000001
1000S0001
10000001
10000001
11111111