NO ./assets/debug_north.png
WE ./assets/debug_west.png
SO ./assets/debug_south.png
EA ./assets/debug_east.png

C 226,147,50
F 4,220,44

11111
10001
10N01
10001
11111