NO ./assets/debug_north.png
WE ./assets/debug_west.png
SO ./assets/debug_south.png
EA ./assets/debug_east.png

C 135,159,214
F 148,114,215

11111
10001
10N01
10001
11111