NO ./assets/debug_north.png
WE ./assets/debug_west.png
SO ./assets/debug_south.png
EA ./assets/debug_east.png

C 79,154,229
F 99,4,48

11111
10001
10N01
10001
11111