NO ./assets/debug_north.png
WE ./assets/debug_west.png
SO ./assets/debug_south.png
EA ./assets/debug_east.png

C 249,66,99
F 101,197,35

11111
10001
10N01
10001
11111