NO ./assets/debug_north.png
WE ./assets/debug_west.png
SO ./assets/debug_south.png
EA ./assets/debug_east.png

C 57,195,136
F 9,149,2

11111
10001
10N01
10001
11111