NO ./assets/debug_north.png
WE ./assets/debug_west.png
SO ./assets/debug_south.png
EA ./assets/debug_east.png

C 141,125,6
F 22,226,229

11111
10001
10N01
10001
11111