NO ./assets/debug_north.png
WE ./assets/debug_west.png
SO ./assets/debug_south.png
EA ./assets/debug_east.png

C 172,183,144
F 179,44,97

11111
10001
10N01
10001
11111