NO ./assets/debug_north.png
WE ./assets/debug_west.png
SO ./assets/debug_south.png
EA ./assets/debug_east.png

C 73,214,234
F 125,82,90

11111
10001
10N01
10001
11111