NO ./assets/debug_north.png
WE ./assets/debug_west.png
SO ./assets/debug_south.png
EA ./assets/debug_east.png

C 112,24,222
F 156,210,87

11111
10001
10N01
10001
11111