NO ./assets/debug_north.png
WE ./assets/debug_west.png
SO ./assets/debug_south.png
EA ./assets/debug_east.png

C 240,13,24
F 28,70,186

11111
10001
10N01
10001
11111