NO ./assets/debug_north.png
WE ./assets/debug_west.png
SO ./assets/debug_south.png
EA ./assets/debug_east.png

C 234,23,53
F 124,147,37

11111
10001
10N01
10001
11111