NO ./assets/debug_north.png
WE ./assets/debug_west.png
SO ./assets/debug_south.png
EA ./assets/debug_east.png

C 212,39,11
F 198,101,140

11111
10001
10N01
10001
11111