NO ./assets/debug_north.png
WE ./assets/debug_west.png
SO ./assets/debug_south.png
EA ./assets/debug_east.png

C 96,236,89
F 255,169,1

11111
10001
10N01
10001
11111