NO ./assets/debug_north.png
WE ./assets/debug_west.png
SO ./assets/debug_south.png
EA ./assets/debug_east.png

C 146,213,152
F 10,57,133

11111
10001
10N01
10001
11111