NO ./assets/debug_north.png
WE ./assets/debug_west.png
SO ./assets/debug_south.png
EA ./assets/debug_east.png

C 46,201,75
F 81,12,50

11111
10001
10N01
10001
11111