NO ./assets/debug_north.png
WE ./assets/debug_west.png
SO ./assets/debug_south.png
EA ./assets/debug_east.png

C 206,98,137
F 242,89,44

11111
10001
10N01
10001
11111