NO ./assets/debug_north.png
WE ./assets/debug_west.png
SO ./assets/debug_south.png
EA ./assets/debug_east.png

C 143,207,112
F 247,198,165

11111
10001
10N01
10001
11111