NO ./assets/debug_north.png
WE ./assets/debug_west.png
SO ./assets/debug_south.png
EA ./assets/debug_east.png

C 86,136,118
F 130,240,193

11111
10001
10N01
10001
11111