NO ./assets/debug_north.png
WE ./assets/debug_west.png
SO ./assets/debug_south.png
EA ./assets/debug_east.png

C 127,232,50
F 92,96,22

11111
10001
10N01
10001
11111