NO ./assets/debug_north.png
WE ./assets/debug_west.png
SO ./assets/debug_south.png
EA ./assets/debug_east.png

C 62,109,156
F 15,12,9

1111111111
1000000001
1000000001
1000000001
1000000001
10000N00001
1000000001
1000000001
1000000001
1111111111