NO ./assets/debug_north.png
WE ./assets/debug_west.png
SO ./assets/debug_south.png
EA ./assets/debug_east.png

C 82,124,166
F 40,32,24

11111
10001
10N001
10001
11111