NO ./assets/debug_north.png
WE ./assets/debug_west.png
SO ./assets/debug_south.png
EA ./assets/debug_east.png

C 110,145,180
F 75,60,45

11111
10001
10N001
10001
11111