NO ./assets/debug_north.png
WE ./assets/debug_west.png
SO ./assets/debug_south.png
EA ./assets/debug_east.png

C 138,166,194
F 110,88,66

11111
10001
10N001
10001
11111