NO ./assets/debug_north.png
WE ./assets/debug_west.png
SO ./assets/debug_south.png
EA ./assets/debug_east.png

C 146,172,198
F 120,96,72

1111111111
1000000001
1000000001
1000000001
1000000001
10000N00001
1000000001
1000000001
1000000001
1111111111