NO ./assets/debug_north.png
WE ./assets/debug_west.png
SO ./assets/debug_south.png
EA ./assets/debug_east.png

C 150,175,200
F 125,100,75

111111111111111
100000000000001
100000000000001
100000000000001
100000000000001
100000000000001
100000000000001
1000000N00000001
100000000000001
100000000000001
100000000000001
100000000000001
100000000000001
100000000000001
111111111111111