NO ./assets/debug_north.png
WE ./assets/debug_west.png
SO ./assets/debug_south.png
EA ./assets/debug_east.png

C 170,190,210
F 150,120,90

1111111
1000001
1000001
100N0001
1000001
1000001
1111111