NO ./assets/debug_north.png
WE ./assets/debug_west.png
SO ./assets/debug_south.png
EA ./assets/debug_east.png

C 194,208,222
F 180,144,108

11111
10001
10N001
10001
11111