NO ./assets/debug_north.png
WE ./assets/debug_west.png
SO ./assets/debug_south.png
EA ./assets/debug_east.png

C 206,217,228
F 195,156,117

111111111111111
100000000000001
100000000000001
100000000000001
100000000000001
100000000000001
100000000000001
1000000N00000001
100000000000001
100000000000001
100000000000001
100000000000001
100000000000001
100000000000001
111111111111111