NO ./assets/debug_north.png
WE ./assets/debug_west.png
SO ./assets/debug_south.png
EA ./assets/debug_east.png

C 222,229,236
F 215,172,129

11111
10001
10N001
10001
11111