NO ./assets/debug_north.png
WE ./assets/debug_west.png
SO ./assets/debug_south.png
EA ./assets/debug_east.png

C 170,142,33
F 200,78,197

11111
10001
10N01
10001
11111