NO ./assets/debug_north.png
WE ./assets/debug_west.png
SO ./assets/debug_south.png
EA ./assets/debug_east.png

C 134,18,3
F 42,136,53

11111
10001
10E01
10001
11111