NO ./assets/debug_north.png
WE ./assets/debug_west.png
SO ./assets/debug_south.png
EA ./assets/debug_east.png

C 0,0,255
F 0,255,0

11111
10001
10N01
10001
11111

11111
10001
10S01
10001
11111
