NO ./assets/debug_north.png
WE ./assets/debug_west.png
SO ./assets/debug_south.png
EA ./assets/debug_east.png

C 214,193,159
F 244,254,181

11111
10001
10W01
10001
11111