NO ./assets/debug_north.png
WE ./assets/debug_west.png
SO ./assets/debug_south.png
EA ./assets/debug_east.png

C 252,206,241
F 9,45,160

11111
10001
10S01
10001
11111