NO ./assets/debug_north.png
WE ./assets/debug_west.png
SO ./assets/debug_south.png
EA ./assets/debug_east.png

C 185,214,35
F 50,213,121

11111
10001
10W01
10001
11111