NO ./assets/debug_north.png
WE ./assets/debug_west.png
SO ./assets/debug_south.png
EA ./assets/debug_east.png

C 242,160,84
F 5,155,161

11111
10001
10N01
10001
11111