NO ./assets/debug_north.png
WE ./assets/debug_west.png
SO ./assets/debug_south.png
EA ./assets/debug_east.png

C 143,76,41
F 60,204,13

11111
10001
10S01
10001
11111