NO ./assets/debug_north.png
WE ./assets/debug_west.png
SO ./assets/debug_south.png
EA ./assets/debug_east.png

C 143,236,243
F 96,189,62

11111
10001
10N01
10001
11111