NO ./assets/debug_north.png
WE ./assets/debug_west.png
SO ./assets/debug_south.png
EA ./assets/debug_east.png

C 225,57,143
F 169,34,230

11111
10001
10S01
10001
11111