NO ./assets/debug_north.png
WE ./assets/debug_west.png
SO ./assets/debug_south.png
EA ./assets/debug_east.png

C 61,110,17
F 240,232,6

11111
10001
10S01
10001
11111