NO ./assets/debug_north.png
WE ./assets/debug_west.png
SO ./assets/debug_south.png
EA ./assets/debug_east.png

C 104,64,83
F 25,16,35

11111
10001
10W01
10001
11111