NO ./assets/debug_north.png
WE ./assets/debug_west.png
SO ./assets/debug_south.png
EA ./assets/debug_east.png

C 23,120,129
F 15,47,52

11111
10001
10N01
10001
11111