NO ./assets/debug_north.png
WE ./assets/debug_west.png
SO ./assets/debug_south.png
EA ./assets/debug_east.png

C 179,95,141
F 87,141,98

11111
10001
10N01
10001
11111