NO ./assets/debug_north.png
WE ./assets/debug_west.png
SO ./assets/debug_south.png
EA ./assets/debug_east.png

C 193,221,175
F 73,238,134

11111
10001
10S01
10001
11111