NO ./assets/debug_north.png
WE ./assets/debug_west.png
SO ./assets/debug_south.png
EA ./assets/debug_east.png

C 53,193,131
F 108,74,245

11111
10001
10E01
10001
11111