NO ./assets/debug_north.png
WE ./assets/debug_west.png
SO ./assets/debug_south.png
EA ./assets/debug_east.png

C 200,130,204
F 62,233,77

11111
10001
10W01
10001
11111