NO ./assets/debug_north.png
WE ./assets/debug_west.png
SO ./assets/debug_south.png
EA ./assets/debug_east.png

C 208,162,225
F 131,253,33

11111
10001
10N01
10001
11111