NO ./assets/debug_north.png
WE ./assets/debug_west.png
SO ./assets/debug_south.png
EA ./assets/debug_east.png

C 136,237,155
F 122,30,233

11111
10001
10S01
10001
11111