NO ./assets/debug_north.png
WE ./assets/debug_west.png
SO ./assets/debug_south.png
EA ./assets/debug_east.png

C 224,178,211
F 16,107,210

11111
10001
10E01
10001
11111