NO ./assets/debug_north.png
WE ./assets/debug_west.png
SO ./assets/debug_south.png
EA ./assets/debug_east.png

C 148,175,43
F 5,84,196

11111
10001
10N01
10001
11111