NO ./assets/debug_north.png
WE ./assets/debug_west.png
SO ./assets/debug_south.png
EA ./assets/debug_east.png

C 251,227,66
F 62,219,19

11111
10001
10S01
10001
11111