NO ./assets/debug_north.png
WE ./assets/debug_west.png
SO ./assets/debug_south.png
EA ./assets/debug_east.png

C 0,255,255
F 255,255,0

111111111
100010001
101010101
100010001
10S010001
100010001
101010101
100010001
111111111