NO ./assets/debug_north.png
WE ./assets/debug_west.png
SO ./assets/debug_south.png
EA ./assets/debug_east.png

C 0,255,255
F 255,255,0

111111111111
100000000001
100000000001
100000000001
100000000001
100000000001
100000S000001
100000000001
100000000001
100000000001
100000000001
111111111111