NO ./assets/debug_north.png
WE ./assets/debug_west.png
SO ./assets/debug_south.png
EA ./assets/debug_east.png

C 0,255,255
F 255,255,0

1111111111111
1000000000001
1000000000001
1000000000001
1000000000001
1000000000001
100000E0000001
1000000000001
1000000000001
1000000000001
1000000000001
1000000000001
1111111111111