NO ./assets/debug_north.png
WE ./assets/debug_west.png
SO ./assets/debug_south.png
EA ./assets/debug_east.png

C 0,255,255
F 255,255,0

11111111111111
10000000000001
10000000000001
10000000000001
10000000000001
10000000000001
10000000000001
1000000N0000001
10000000000001
10000000000001
10000000000001
10000000000001
10000000000001
11111111111111