NO ./assets/debug_north.png
WE ./assets/debug_west.png
SO ./assets/debug_south.png
EA ./assets/debug_east.png

C 255,0,0
F 0,0,255

1111111
1111111
1111111
111N111
1111111
1111111
1111111