NO ./assets/debug_north.png
WE ./assets/debug_west.png
SO ./assets/debug_south.png
EA ./assets/debug_east.png

C 255,200,100
F 100,200,255

11111111111111
10000000000001
10000000000001
10000000000001
10000000000001
10000000000001
10000000000001
1000000E0000001
10000000000001
10000000000001
10000000000001
10000000000001
10000000000001
11111111111111