NO ./assets/debug_north.png
WE ./assets/debug_west.png
SO ./assets/debug_south.png
EA ./assets/debug_east.png

C 10,6,14
F 4,22,26

1111
1001
10N01
1111