NO ./assets/debug_north.png
WE ./assets/debug_west.png
SO ./assets/debug_south.png
EA ./assets/debug_east.png

C 15,9,21
F 6,33,39

1111
1001
10N01
1111