NO ./assets/debug_north.png
WE ./assets/debug_west.png
SO ./assets/debug_south.png
EA ./assets/debug_east.png

C 20,12,28
F 8,44,52

11111
10001
10N001
10001
11111