NO ./assets/debug_north.png
WE ./assets/debug_west.png
SO ./assets/debug_south.png
EA ./assets/debug_east.png

C 25,15,35
F 10,55,65

11111
10001
10N001
10001
11111