NO ./assets/debug_north.png
WE ./assets/debug_west.png
SO ./assets/debug_south.png
EA ./assets/debug_east.png

C 55,33,77
F 22,121,143

11111111
10000001
10000001
10000001
1000N0001
10000001
10000001
11111111