NO ./assets/debug_north.png
WE ./assets/debug_west.png
SO ./assets/debug_south.png
EA ./assets/debug_east.png

C 90,54,126
F 36,198,234

111111111111
100000000001
100000000001
100000000001
100000000001
100000000001
100000N000001
100000000001
100000000001
100000000001
100000000001
111111111111