NO ./assets/debug_north.png
WE ./assets/debug_west.png
SO ./assets/debug_south.png
EA ./assets/debug_east.png

C 120,72,168
F 48,9,57

111111111111111
100000000000001
100000000000001
100000000000001
100000000000001
100000000000001
100000000000001
1000000N00000001
100000000000001
100000000000001
100000000000001
100000000000001
100000000000001
100000000000001
111111111111111